border_size=1
usage=map

Xos         , Xos         , Xos         , Xos         , Xos         , Xos         , Xos         , Xos         , Xos         , Xos         , Xos         , Xos         , Xos         , Xos         , Xos         , Xos         , Xos         , Xos         , Xos         , Xos         , Xos         , Xos         , Xos         , Xos         , Xos         , Xos         , Xos         , Xos         , Uu          , Uu          , Xos         , Xos         , Xos         , Xos         , Xos         
Xos         , Xos         , Xos         , Xos         , Uu^Vud      , Xos         , Uu^Vud      , Xos         , Uu^Vud      , Xos         , Uu^Vud      , Xos         , Uu^Vud      , Xos         , Xos         , Xos         , Xos         , Xos         , Xos         , Xos         , Xos         , Xos         , Cud         , Cud         , Cud         , Xos         , Xos         , Xos         , Uu          , Uu          , Cud         , Xos         , Xos         , Xos         , Xos         
Xos         , Xos         , Uu^Vud      , Uu^Vud      , Ur          , Uu^Vud      , Uu^Vud      , Uu^Vud      , Ur          , Uu^Vud      , Ur          , Uu^Vud      , Ur          , Uu^Vud      , Uu^Vud      , Xos         , Xos         , Xos         , Xos         , Xos         , Xos         , Cud         , Cud         , Cud         , Cud         , Cud         , Xos         , Cud         , Ur          , Uu          , Xos         , Xos         , Xos         , Xos         , Xos         
Xos         , Xos         , Uu^Vud      , Ur          , Uu^Vud      , Uu^Vud      , Uu^Vud      , Ur          , Ur          , Uu^Vud      , Ur          , Ur          , Uu^Vud      , Ur          , Ur          , Uu^Vud      , Uu^Vud      , Xos         , Xos         , Xos         , Xos         , Xos         , Xos         , Cud         , Ur          , Xos         , Xos         , Xos         , Ur          , Ur          , Xos         , Xos         , Xos         , Xos         , Xos         
Xos         , Xos         , Uu^Vud      , Ur          , Uu^Vud      , Uu^Vud      , Ur          , Uu^Vud      , Ur          , Ur          , Uu^Vud      , Uu^Vud      , Xos         , Uu^Vud      , Uu^Vud      , Uu^Vud      , Xos         , Xos         , Xos         , Xos         , Cud         , Xos         , Xos         , Ur          , Ur          , Ur          , Ur          , Ur          , Ur          , Ur          , Xos         , Xos         , Xos         , Xos         , Xos         
Xos         , Xos         , Uu^Vud      , Ur          , Ur          , Uu^Vud      , Ur          , Uu^Vud      , Ur          , Uu^Vud      , Uu^Vud      , Xos         , Xos         , Xos         , Xos         , Xos         , Xos         , Xos         , Cud         , Cud         , 2 Kud       , Cud         , Cud         , Xos         , Xos         , Ur          , Ur          , Ur          , Ur          , Ur          , Ur          , Xos         , Xos         , Xos         , Xos         
Xos         , Xos         , Xos         , Uu^Vud      , Ur          , Uu^Vud      , Ur          , Uu^Vud      , Uu^Vud      , Ur          , Ur          , Uu^Vud      , Uu^Vud      , Xos         , Xos         , Xos         , Cud         , Cud         , Cud         , Cud         , Cud         , Cud         , Cud         , Cud         , Cud         , Xos         , Xos         , Xos         , Ur          , Ur          , Ur          , Ur          , Ur          , Xos         , Xos         
Xos         , Xos         , Xos         , Uu^Vud      , Uu^Vud      , Ur          , Ur          , Ur          , Ur          , Ur          , Uu^Vud      , Uu^Vud      , Xos         , Xos         , Uu^Vud      , Xu          , Xu          , Cud         , Cud         , Cud         , Cud         , Cud         , Cud         , Cud         , Xu          , Xu          , Uu^Vud      , Xos         , Xos         , Ur          , Ur          , Ur          , Ur          , Xos         , Xos         
Xos         , Xos         , Xos         , Xos         , Ur          , Ur          , Uu^Vud      , Uu^Vud      , Uu^Vud      , Uu^Vud      , Xos         , Xos         , Uu^Vud      , Uu^Vud      , Ur          , Uu^Vud      , Uu^Vud      , Xu          , Xu          , Cud         , Cud         , Cud         , Xu          , Xu          , Uu^Vud      , Uu^Vud      , Ur          , Uu^Vud      , Uu^Vud      , Xos         , Xos         , Ur          , Ur          , Ur          , Xos         
Xos         , Xos         , Ur          , Ur          , Uu^Vud      , Uu^Vud      , Xos         , Xos         , Xos         , Xos         , Uu^Vud      , Uu^Vud      , Ur          , Uu^Vud      , Uu^Vud      , Ur          , Ur          , Uu^Vud      , Uu^Vud      , Xu          , Ur          , Xu          , Uu^Vud      , Uu^Vud      , Ur          , Ur          , Uu^Vud      , Uu^Vud      , Ur          , Uu^Vud      , Uu^Vud      , Xos         , Ur          , Ur          , Xos         
Xos         , Uu^Vud      , Ur          , Uu^Vud      , Xos         , Xos         , Xos         , Xos         , Xos         , Xos         , Xos         , Uu^Vud      , Uu^Vud      , Ur          , Ur          , Uu^Vud      , Uu^Vud      , Ur          , Ur          , Cud         , Ur          , Cud         , Ur          , Ur          , Uu^Vud      , Uu^Vud      , Ur          , Ur          , Uu^Vud      , Uu^Vud      , Xos         , Xos         , Ur          , Ur          , Xos         
Xos         , Uu^Vud      , Ur          , Uu^Vud      , Xos         , Xos         , Xos         , Xos         , Xos         , Xos         , Xos         , Xos         , Xos         , Uu^Vud      , Uu^Vud      , Ur          , Ur          , Uu^Vud      , Uu^Vud      , Ur          , Ur          , Ur          , Uu^Vud      , Uu^Vud      , Ur          , Ur          , Uu^Vud      , Uu^Vud      , Xos         , Xos         , Ur          , Ur          , Ur          , Ur          , Xos         
Xos         , Uu^Vud      , Ur          , Uu^Vud      , Xos         , Uu^Vud      , Uu^Vud      , Xos         , Uu^Vud      , Xos         , Ur          , Xos         , Xos         , Xos         , Xos         , Uu^Vud      , Uu^Vud      , Ur          , Ur          , Ur          , Ur          , Ur          , Ur          , Ur          , Uu^Vud      , Uu^Vud      , Xos         , Xos         , Ur          , Ur          , Ur          , Ur          , Xos         , Xos         , Xos         
Xos         , Uu^Vud      , Ur          , Uu^Vud      , Uu^Vud      , Uu^Vud      , Ur          , Uu^Vud      , Uu^Vud      , Ur          , Uu^Vud      , Uu^Vud      , Xos         , Xos         , Xos         , Xos         , Xos         , Uu^Vud      , Uu^Vud      , Ur          , Ur          , Ur          , Uu^Vud      , Uu^Vud      , Xos         , Xos         , Cud         , Cud         , Cud         , Ur          , Ur          , Ur          , Ur          , Xos         , Xos         
Xos         , Uu^Vud      , Uu^Vud      , Ur          , Uu^Vud      , Uu^Vud      , Ur          , Uu^Vud      , Uu^Vud      , Ur          , Uu^Vud      , Xos         , Xos         , Xos         , Xos         , Xos         , Xos         , Xos         , Xos         , Cud         , Ur          , Cud         , Xos         , Xos         , Cud         , Cud         , Cud         , Cud         , Xos         , Xos         , Ur          , Ur          , Ur          , Ur          , Xos         
Xos         , Xos         , Uu^Vud      , Ur          , Uu^Vud      , Uu^Vud      , Ur          , Uu^Vud      , Uu^Vud      , Ur          , Uu^Vud      , Xos         , Xos         , Xos         , Xos         , Xos         , Xos         , Xos         , Ur          , Ur          , Ur          , Ur          , Ur          , Xos         , Xos         , Cud         , Xos         , Xos         , Ur          , Ur          , Ur          , Ur          , Xos         , Xos         , Xos         
Xos         , Xos         , Uu^Vud      , Ur          , Uu^Vud      , Uu^Vud      , Ur          , Uu^Vud      , Ur          , Ur          , Uu^Vud      , Xos         , Xos         , Xos         , Xos         , Xos         , Ur          , Ur          , Ur          , Ur          , Xos         , Ur          , Ur          , Ur          , Ur          , Xos         , Ur          , Ur          , Ur          , Ur          , Xos         , Xos         , Xos         , Xos         , Xos         
Xos         , Xos         , Uu^Vud      , Ur          , Uu^Vud      , Uu^Vud      , Ur          , Ur          , Uu^Vud      , Uu^Vud      , Xos         , Xos         , Xos         , Xos         , Ur          , Ur          , Ur          , Ur          , Xos         , Xos         , Cud         , Xos         , Xos         , Ur          , Ur          , Ur          , Ur          , Ur          , Xos         , Xos         , Xos         , Xos         , Xos         , Xos         , Xos         
Xos         , Xos         , Uu^Vud      , Ur          , Ur          , Ur          , Ur          , Ur          , Xos         , Xos         , Xos         , Xos         , Ur          , Ur          , Ur          , Ur          , Xos         , Xos         , Ur          , Ur          , Ur          , Ur          , Ur          , Xos         , Xos         , Ur          , Xos         , Xos         , Xos         , Xos         , Xos         , Xos         , Xos         , Xos         , Xos         
Xos         , Uu^Vud      , Ur          , Ur          , Uu^Vud      , Uu^Vud      , Xos         , Ur          , Ur          , Xos         , Ur          , Ur          , Ur          , Ur          , Xos         , Xos         , Ur          , Ur          , Ur          , Ur          , Xos         , Ur          , Ur          , Ur          , Ur          , Xos         , Cud         , Xos         , Xos         , Xos         , Xos         , Xos         , Xos         , Xos         , Xos         
Xos         , Uu^Vud      , Uu^Vud      , Uu^Vud      , Xos         , Xos         , Xos         , Xos         , Ur          , Ur          , Ur          , Ur          , Ur          , Xos         , Ur          , Ur          , Ur          , Ur          , Xos         , Xos         , Uu^Vud      , Xos         , Xos         , Ur          , Ur          , Ur          , Ur          , Xos         , Cud         , Xos         , Qxu         , Xos         , Qxu         , Xos         , Xos         
Xos         , Xos         , Xos         , Xos         , Uu^Vud      , Uu^Vud      , Ur          , Ur          , Ur          , Xos         , Xos         , Ur          , Ur          , Ur          , Ur          , Ur          , Ur          , Xos         , Uu^Vud      , Uu^Vud      , Ur          , Uu^Vud      , Xos         , Xos         , Cud         , Ur          , Ur          , Ur          , Ur          , Qxu         , Qxu         , Qxu         , Qxu         , Qxu         , Qxu         
Xos         , Xos         , Uu^Vud      , Uu^Vud      , Ur          , Ur          , Uu^Vud      , Uu^Vud      , Ur          , Uu^Vud      , Xos         , Xos         , Xos         , Cud         , Xos         , Xos         , Ur          , Ur          , Ur          , Ur          , Ur          , Uu^Vud      , Xos         , Xos         , Xos         , Xos         , Cud         , Ur          , Ur          , Ur          , Ur          , Qxu         , Qxu         , Qxu         , Qxu         
Xos         , Uu^Vud      , Ur          , Ur          , Ur          , Ur          , Ur          , Ur          , Ur          , Uu^Vud      , Uu^Vud      , Xos         , Xos         , Xos         , Xos         , Uu^Vud      , Uu^Vud      , Uu^Vud      , Uu^Vud      , Uu^Vud      , Uu^Vud      , Uu^Vud      , Xos         , Xos         , Xos         , Xos         , Qxu         , Qxu         , Qxu         , Ur          , Ur          , Ur          , Ur^Ii       , Qxu^Ii      , Qxu^Ii      
Xos         , Uu^Vud      , Uu^Vud      , Uu^Vud      , Uu^Vud      , Uu^Vud      , Uu^Vud      , Uu^Vud      , Uu^Vud      , Uu^Vud      , Xos         , Xos         , Xos         , Xos         , Xos         , Xos         , Xos         , Xos         , Xos         , Xos         , Xos         , Xos         , Xos         , Xos         , Xos         , Xos         , Xos         , Qxu         , Qxu         , Qxu         , Qxu         , Ur^Ii       , 1 Ur^Ii     , Ur^Ii       , Uu^Ii       
Xos         , Xos         , Xos         , Xos         , Xos         , Xos         , Xos         , Xos         , Xos         , Xos         , Xos         , Xos         , Xos         , Xos         , Xos         , Xos         , Xos         , Xos         , Xos         , Xos         , Xos         , Xos         , Xos         , Xos         , Xos         , Xos         , Xos         , Xos         , Xos         , Qxu         , Qxu         , Qxu^Ii      , Qxu^Ii      , Ur^Ii       , Ur^Ii       
