border_size=1
usage=map

Xu          , Xu          , Xu          , Xu          , Wwf         , Wwf         , Wwf         , Wwf         , Xu          , Uu          , Xu          , Xu          , Xu          , Xu          , Xu          , Uu          , Xu          , Xu          , Xu          , Xu          , Xu          , Xu          , Xu          , Xu          , Xu          , Xu          , Xu          , Xu          , Xu          , Xu          , Xu          , Xu          , Xu          , Xu          , Xu          , Xu          , Xu          , Xu          , Xu          , Xu          , Xu          , Xu          , Xu          , Xu          , Xu          , Uu          , Xu          
Xu          , Xu          , Xu          , Xu          , 2 Wwf       , Wwf         , Xu          , Xu          , Xu          , Xu          , Xu          , Xu          , Uh          , Uu          , Uu          , Uu          , Xu          , Xu          , Uu          , Xu          , Xu          , Xu          , Xu          , Xu          , Xu          , Xu          , Xu          , Xu          , Xu          , Xu          , Xu          , Xu          , Xu          , Xu          , Xu          , Xu          , Xu          , Xu          , Xu          , Xu          , Xu          , Xu          , Xu          , Xu          , Xu          , Xu          , Xu          
Xu          , Xu          , Xu          , Xu          , Wwf         , Wwf         , Xu          , Xu          , Xu          , Xu          , Xu          , Uu          , Uh          , Uu          , Uh          , Uu          , Uh          , Xu          , Uu          , Uu          , Uh          , Ds^Ii       , Xu          , Xu          , Uh          , Xu          , Uh          , Xu          , Xu          , Xu          , Xu          , Xu          , Xu          , Xu          , Xu          , Xu          , Xu          , Xu          , Xu          , Xu          , Xu          , Xu          , Xu          , Xu          , Xu          , Xu          , Xu          
Xu          , Xu          , Xu          , Xu          , Wwf         , Xu          , Uu          , Xu          , Xu          , Xu          , Uh          , Uu          , Uu          , Uu          , Uu          , Uh          , Uh          , Uu          , Xu          , Uu          , Xu          , Xu          , Xu          , Xu          , Uu          , Uu          , Uu          , Uh          , Xu          , Xu          , Uu          , Uu          , Uu          , Xu          , Xu          , Xu          , Xu          , Xu          , Xu          , Xu          , Xu          , Xu          , Xu          , Xu          , Uu          , Xu          , Xu          
Chw         , Ww          , Ww          , Uu          , Wwf         , Wwf         , Uu          , Cud         , Uu          , Xu          , Uh          , Uu          , Uu          , Uh          , Xu          , Uu          , Xu          , Xu          , Xu          , Xu          , Xu          , Xu          , Xu          , Uh          , Uh          , Uu          , Uu          , Uu          , Uu          , Xu          , Xu          , Xu          , Uh          , Uu          , Uu          , Xu          , Xu          , Uu          , Uh          , Uu          , Uu          , Xu          , Xu          , Uu          , Uh          , Uu          , Xu          
Chw         , Chw         , Ww          , Wwf         , Ww          , Uu          , Ur          , Cud         , Xu          , Uu          , Uh          , Uu          , Uu          , Uh          , Xu          , Xu          , Xu          , Xu          , Xu          , Xu          , Uu          , Xu          , Xu          , Xu          , Xu          , Uh          , Uu          , Uu          , Ur          , Uu          , Uu          , Xu          , Uh          , Uu          , Uu          , Uu          , Uu          , Uu          , Xu          , Uu          , Xu          , Xu          , Uu          , Uh          , Uu          , Uu          , Xu          
Ww          , Chw         , Ur          , Ww          , Ur          , Ur          , Uu          , Uu          , Xu          , Uu          , Xu          , Uu          , Uu          , Xu          , Uu          , Uu          , Xu          , Xu          , Uu          , Uu          , Uu          , Xu          , Xu          , Xu          , Xu          , Uu          , Uu          , Uu          , Uu          , Ur          , Ur          , Uu          , Uu          , Uu          , Xu          , Xu          , Xu          , Xu          , Uu          , Uu          , Uu          , Xu          , Xu          , Uh          , Xu          , Uu          , Xu          
Xu          , Ww          , Uh          , Ur          , Uu          , Uu          , Xu          , Xu          , Uu          , Xu          , Xu          , Uu          , Uu          , Uu          , Uu          , Uu          , Xu          , Uu          , Uu          , Uu          , Uu          , Xu          , Xu          , Xu          , Xu          , Xu          , Xu          , Uu          , Uu          , Ur          , Ur          , Ur          , Uu          , Uu          , Xu          , Xu          , Uu          , Uu          , Uu          , Uu          , Uu          , Uu          , Uu          , Xu          , Xu          , Uu          , Xu          
Xu          , Xu          , Cud         , Ur          , Xu          , Uu          , Xu          , Xu          , Uu          , Uu          , Xu          , Uu          , Uu          , Uu          , Uu          , Uu          , Xu          , Uu          , Uu          , Uu          , Uu          , Uu          , Xu          , Xu          , Xu          , Xu          , Xu          , Xu          , Xu          , Xu          , Xu          , Uu          , Xu          , Xu          , Uh          , Uu          , Uu          , Uu          , Uh          , Uu          , Uh          , Uu          , Uu          , Uu          , Uu          , Uu          , Xu          
Xu          , Uu          , Xu          , Xu          , Uu          , Xu          , Uu          , Uu          , Uu          , Uu          , Cud         , Xu          , Xu          , Uu          , Xu          , Xu          , Uu          , Uu          , Uu          , Uu          , Uu          , Uu          , Uu          , Ur          , Ur          , Uu          , Uu          , Xu          , Uu          , Uu          , Uu          , Uu          , Uh          , Uh          , Uu          , Uu          , Uu          , Uh          , Uu          , Uh          , Uu          , Uu          , Uh          , Uu          , Uu          , Xu          , Xu          
Xu          , Uu          , Uu          , Uu          , Xu          , Uu          , Uu          , Uu          , Uu          , Cud         , Uu          , Xu          , Uu          , Xu          , Uu          , Xu          , Uu          , Uu          , Xu          , Uu          , Uu          , Uu          , Uu          , Ur          , Ur          , Ur          , Ur          , Uu          , Uu          , Uu          , Uu          , Uu          , Uh          , Uu          , Uu          , Uu          , Uu          , Uu          , Uu          , Uu          , Uu          , Uh          , Uu          , Uu          , Xu          , Xu          , Qlf         
Xu          , Uu          , Uu          , Uu          , Xu          , Xu          , Uu          , Uu          , Uu          , Xu          , Uu          , Uu          , Uu          , Uu          , Uu          , Uu          , Uu          , Uu          , Xu          , Xu          , Uu          , Uu          , Uu          , Uu          , Ur          , Xu          , Ur          , Uu          , Xu          , Uu          , Uu          , Uu          , Uu          , Uu          , Uu          , Uu          , Uu          , Uu          , Uu          , Uu          , Uu          , Uu          , Uu          , Uu          , Qlf         , Qlf         , Xu          
Xu          , Uu          , Uu          , Uu          , Uu          , Uu          , Uu          , Uu          , Uu          , Xu          , Uu          , Uu          , Uu          , Uu          , Uu          , Uu          , Uu          , Uu^Uf       , Xu          , Uu          , Uu          , Uu          , Uu^Uf       , Uu          , Xu          , Ur          , Uu          , Uu          , Uu          , Uu          , Uu          , Uu          , Uu          , Uu          , Uu          , Uu          , Uu          , Uh          , Uu          , Uu          , Uu          , Uu          , Uu          , Uu          , Qlf^Bw\     , Qlf         , Xu          
Xu          , Uu          , Uu          , Uu          , Uu          , Xu          , Uu          , Uu          , Uu          , Xu          , Xu          , Uu          , Uu          , Uu          , Uu          , Uu          , Uu          , Uu^Uf       , Xu          , Uu          , Uu          , Uu          , Uu^Uf       , Uu^Uf       , Uu^Uf       , Uu          , Uu          , Uu          , Uu          , Uu          , Uu          , Uu          , Uu          , Uu          , Uu          , Uu          , Qlf         , Uu          , Uu          , Uu          , Uu          , Uu          , Qlf         , Qlf         , Qlf         , Uu          , Xu          
Xu          , Uu          , Uu          , Ur          , Ur          , Xu          , Uu          , Uu          , Uu          , Uu          , Uu          , Xu          , Xu          , Xu          , Xu          , Xu          , Xu          , Xu          , Uu          , Uu          , Uu          , Uu          , Uu          , Uu          , Uu          , Uu          , Uu          , Uu          , Uu          , Uu          , Qlf         , Uu          , Uu          , Uu          , Uu          , Qlf         , Qlf         , Qlf         , Qlf         , Qlf         , Qlf         , Qlf         , Qlf         , Xu          , Xu          , Uu          , Xu          
Xu          , Uu          , Uu          , Ur          , Uu          , Uu          , Uu          , Uu          , Uu          , Uu          , Uu          , Uu          , Uu          , Uu          , Uu^Uf       , Uu^Uf       , Cud         , Uu          , Uu          , Uu          , Uu          , Uu          , Uu          , Uu          , Qlf         , Uu          , Uu          , Uu          , Qlf         , Qlf         , Uu          , Qlf         , Qlf         , Qlf         , Qlf         , Qlf         , Qlf         , Qlf         , Qlf         , Qlf         , Uu          , Uu          , Xu          , Xu          , Uu          , Uu          , Xu          
Xu          , Xu          , Ur          , Ur          , Uu          , Xu          , Uu          , Uu          , Uu          , Uu          , Uu          , Uu          , Uu^Uf       , Uu^Uf       , Uu^Uf       , Uu          , Uu          , Cud         , Xu          , Xu          , Uu          , Uu          , Qlf^Bw\     , Qlf         , Uu          , Qlf         , Qlf         , Qlf         , Xu          , Xu          , Uu          , Uu          , Uu          , Qlf         , Uu          , Uu          , Uu          , Qlf         , Uu          , Uu          , Uu          , Uu          , Xu          , Uu          , Uu          , Xu          , Xu          
Xu          , Ur          , Uu          , Uu          , Xu          , Xu          , Xu          , Uu          , Xu          , Xu          , Xu          , Uu          , Uu          , Uu          , Uh          , Ur          , Cud         , Cud         , Xu          , Xu          , Qlf         , Qlf         , Uu          , Uu          , Uu          , Uu          , Uu          , Uu          , Xu          , Xu          , Uu          , Uu          , Uu          , Uu          , Uu          , Uu          , Uu          , Uu          , Xu          , Uu          , Xu          , Xu          , Uh          , Uh          , Xu          , Xu          , Xu          
Xu          , Xu          , Uu          , Uu          , Xu          , Xu          , Uu          , Xu          , Uu          , Uu          , Uu          , Xu          , Uu          , Uh          , Xu          , Cud         , Uu          , Xu          , Xu          , Uu          , Qlf         , Uu          , Uu          , Uu          , Uu          , Uu          , Uu          , Uu          , Uu          , Uu          , Uu          , Uu          , Uu          , Uu          , Xu          , Xu          , Xu          , Xu          , Uu          , Uu          , Xu          , Uh          , Xu          , Xu          , Uh          , Uu          , Xu          
Xu          , Uu          , Uu          , Xu          , Uu          , Ur          , Xu          , Uu          , Uh          , Uu          , Xu          , Xu          , Xu          , Xu          , Uu          , Uu          , Xu          , Xu          , Qlf         , Qlf         , Uu          , Uu          , Uu          , Uu          , Uu          , Ur          , Ur          , Uu          , Uu          , Xu          , Xu          , Uu          , Xu          , Xu          , Xu          , Xu          , Uu          , Uu          , Xu          , Xu          , Uh          , Uu          , Xu          , Xu          , Uu          , Uu          , Xu          
Xu          , Uu          , Xu          , Xu          , Xu          , Ur          , Ur          , Xu          , Uu          , Xu          , Xu          , Xu          , Xu          , Uu          , Uu          , Xu          , Uu          , Uu          , Uu          , Qlf         , Uu          , Uu          , Uu          , Uu          , Uu          , Uu          , Uu          , Uu          , Uu          , Uu          , Xu          , Uu          , Xu          , Xu          , Uu          , Uu          , Xu          , Xu          , Xu          , Uu          , Xu          , Xu          , Uu          , Uu          , Uu          , Xu          , Xu          
Xu          , Xu          , Xu          , Uu          , Ur          , Xu          , Ur          , Xu          , Uu          , Uu          , Uu          , Xu          , Uu          , Uu          , Xu          , Xu          , Uu          , Uu          , Uu          , Qlf         , Uu          , Uu          , Uu          , Uh          , Uh          , Uu          , Uu          , Uu          , Ur          , Uu          , Xu          , Uu          , Uu          , Uu          , Xu          , Xu          , Xu          , Xu          , Uh          , Uh          , Xu          , Xu          , Uh          , Uu          , Uu          , Uu          , Xu          
Xu          , Uu          , Uh          , Uh          , Xu          , Ur          , Xu          , Xu          , Uu          , Uu          , Uu          , Uu          , Uu          , Uu          , Xu          , Xu          , Uu          , Uu          , Qlf         , Qlf         , Xu          , Uu          , Xu          , Uh          , Uh          , Uh          , Uu          , Uu          , Uu          , Uh          , Uu          , Uu          , Xu          , Uu          , Uu          , Xu          , Uu          , Uh          , Xu          , Xu          , Uu          , Xu          , Uu          , Uu          , Xu          , Uu          , Xu          
Xu          , Uu          , Uu          , Uu          , Xu          , Xu          , Xu          , Uu          , Uu          , Uu          , Uu          , Uu          , Uu          , Uu          , Xu          , Uu          , Uu          , Uu          , Qlf         , Qlf         , Uu          , Xu          , Xu          , Xu          , Xu          , Uh          , Uh          , Uu          , Ur          , Uu          , Uu          , Xu          , Xu          , Xu          , Xu          , Uu          , Xu          , Xu          , Uu^Uf       , Uu          , Uu          , Uu          , Uu          , Uu          , Xu          , Uu          , Xu          
Xu          , Uh          , Uu          , Xu          , Xu          , Uu^Uf       , Uu^Uf       , Xu          , Uu          , Uu          , Uu          , Uu          , Uu          , Xu          , Uu          , Uu          , Uu          , Uu          , Qlf^Bw\     , Uu          , Uu          , Uu          , Uu          , Uu          , Uu          , Uu          , Uh          , Uu          , Uu          , Uu          , Uu          , Uu          , Uu          , Uu          , Uu          , Uu          , Uu          , Uh          , Uh          , Uh          , Uu          , Uu          , Xu          , Xu          , Uu          , Uu          , Xu          
Xu          , Uh          , Uu          , Xu          , Xu          , Uu^Uf       , Uu^Uf       , Xu          , Xu          , Uu          , Uu          , Uu          , Xu          , Xu          , Uu          , Uu          , Uu          , Uu          , Qlf         , Ur          , Ur          , Uu          , Ur          , Uu          , Uu          , Uu          , Xu          , Uu          , Uu          , Uu          , Uu          , Uu          , Uu          , Uu          , Uu          , Uu          , Uu          , Uu^Uf       , Uu^Uf       , Uu          , Uu          , Xu          , Uu          , Uu          , Uu          , Uu          , Xu          
Xu          , Uh          , Uh          , Xu          , Xu          , Uu^Uf       , Uu^Uf       , Uu^Uf       , Xu          , Uu          , Uu          , Xu          , Uu          , Uu          , Uu          , Uu          , Uu          , Uu          , Qlf         , Uu          , Uu          , Ur          , Uu          , Ur          , Ur          , Uu          , Uu          , Ur          , Uu          , Uu          , Xu          , Uu          , Uu          , Uu          , Uu          , Uu          , Xu          , Uu^Uf       , Uu          , Uu          , Xu          , Xu          , Uu          , Uu          , Uh          , Uu          , Xu          
Xu          , Uu          , Uh          , Uu          , Xu          , Uu^Uf       , Uu^Uf       , Uu^Uf       , Uu^Uf       , Uu^Uf       , Uh          , Uu          , Uu          , Uu          , Uu          , Uu          , Xu          , Qlf         , Qlf^Bw/     , Uu          , Xu          , Uh          , Uu          , Xu          , Uu          , Uu          , Uu          , Uu          , Xu          , Uu          , Uh          , Uh          , Uu          , Uu          , Uu          , Uu          , Uu          , Xu          , Uu          , Xu          , Uu          , Uu          , Uu          , Uu          , Uh          , Uh          , Xu          
Xu          , Uu          , Uu          , Uu          , Uu          , Xu          , Xu          , Uu^Uf       , Xu          , Uu^Uf       , Uh          , Uh          , Xu          , Xu          , Xu          , Xu          , Uu          , Qlf^Bw/     , Qlf         , Xu          , Xu          , Xu          , Xu          , Xu          , Xu          , Uu          , Uu          , Xu          , Uu          , Uu          , Uu          , Uh          , Uu          , Uu          , Uu          , Uu          , Uu          , Xu          , Xu          , Uu          , Xu          , Uu          , Uu          , Uu          , Uu          , Uu          , Xu          
Xu          , Uu          , Uu          , Uh          , Uu          , Xu          , Xu          , Xu          , Xu          , Xu          , Xu          , Xu          , Xu          , Xu          , Uu          , Uu          , Uu          , Qlf         , Xu          , Xu          , Xu          , Xu          , Xu          , Xu          , Xu          , Uu          , Uu          , Uu          , Uu          , Uu          , Uu          , Uu          , Xu          , Xu          , Uu          , Uu          , Uu          , Uu          , Uu          , Xu          , Uu          , Xu          , Uu          , Uu          , Xu          , Xu          , Xu          
Xu          , Uh          , Uh          , Uu          , Uh          , Uu          , Xu          , Xu          , Xu          , Xu          , Xu          , Xu          , Xu          , Xu          , Xu          , Uu          , Xu          , Qlf         , Qlf         , Xu          , Xu          , Xu          , Xu          , Xu          , Xu          , Xu          , 1 Uu        , Uu          , Xu          , Xu          , Xu          , Xu          , Uu          , Uu          , Uu          , Uu          , Uu          , Uu          , Uu          , Uu          , Uu          , Uu          , Xu          , Xu          , Xu          , Xu          , Xu          
Xu          , Xu          , Xu          , Xu          , Xu          , Xu          , Xu          , Xu          , Xu          , Xu          , Xu          , Xu          , Xu          , Xu          , Xu          , Xu          , Xu          , Xu          , Qlf         , Xu          , Xu          , Xu          , Xu          , Xu          , Xu          , Xos         , Uu          , Uu          , Xos         , Xu          , Xu          , Xu          , Xu          , Xu          , Xu          , Xu          , Xu          , Xu          , Xu          , Xu          , Xu          , Xu          , Xu          , Xu          , Xu          , Xu          , Xu          
