border_size=1
usage=map

Gg          , Gg^Efm      , Gg          , Re^Gvs      , Re^Gvs      , Re^Gvs      , Re^Gvs      , Re^Gvs      , Re^Gvs      , Re^Gvs      , Re^Gvs      , Re^Gvs      , Gg^Eff      , Gg^Eff      , Re^Gvs      , Rb          , Rb          , Re^Gvs      , Re^Gvs      , Re^Gvs      , Re^Gvs      , Re^Gvs      , Re^Gvs      , Re^Gvs      , Re^Gvs      , Re^Gvs      , Re^Gvs      , Gg^Eff      , Gg^Eff      , Re^Gvs      , Re^Gvs      , Re^Gvs      , Re^Gvs      , Re^Gvs      , Re^Gvs      , Re^Gvs      , Rb          , Rb          , Re^Gvs      , Re^Gvs      , Re^Gvs      , Re^Gvs      , Re^Gvs      , Re^Gvs      , Re^Gvs      , Re^Gvs      , Gg^Wm       , Re^Gvs      , Re^Gvs      , Re^Gvs      , Re^Gvs      , Re^Gvs      
Gg          , Gg^Efm      , Gg          , Re^Gvs      , Re^Gvs      , Re^Gvs      , Re^Gvs      , Re^Gvs      , Re^Gvs      , Re^Gvs      , Gg^Eff      , Gg^Eff      , Re^Gvs      , Re^Gvs      , Re^Gvs      , Re^Gvs      , Re^Gvs      , Rb          , Re^Gvs      , Re^Gvs      , Re^Gvs      , Re^Gvs      , Re^Gvs      , Re^Gvs      , Re^Gvs      , Re^Gvs      , Re^Gvs      , Gg^Eff      , Gg^Eff      , Re^Gvs      , Re^Gvs      , Re^Gvs      , Re^Gvs      , Re^Gvs      , Re^Gvs      , Re^Gvs      , Rb          , Re^Gvs      , Re^Gvs      , Re^Gvs      , Re^Gvs      , Re^Gvs      , Re^Gvs      , Re^Gvs      , Re^Gvs      , Re^Gvs      , Re^Gvs      , Re^Gvs      , Re^Gvs      , Re^Gvs      , Re^Gvs      , Re^Gvs      
Gg          , Gg^Efm      , Gg^Efm      , Gg          , Re^Gvs      , Re^Gvs      , Re^Gvs      , Re^Gvs      , Gg^Eff      , Gg^Eff      , Re^Gvs      , Re^Gvs      , Re^Gvs      , Re^Gvs      , Re^Gvs      , Re^Gvs      , Re^Gvs      , Rb          , Rp          , Re^Gvs      , Re^Gvs      , Re^Gvs      , Re^Gvs      , Re^Gvs      , Re^Gvs      , Re^Gvs      , Re^Gvs      , Gg^Eff      , Gg^Eff      , Re^Gvs      , Re^Gvs      , Re^Gvs      , Re^Gvs      , Re^Gvs      , Re^Gvs      , Rb          , Re^Gvs      , Re^Gvs      , Re^Gvs      , Re^Gvs      , Re^Gvs      , Re^Gvs      , Gg^Eff      , Re^Gvs      , Gg^Eff      , Re^Gvs      , Re^Gvs      , Re^Gvs      , Gg^Eff      , Re^Gvs      , Re^Gvs      , Re^Gvs      
Ww          , Gg^Efm      , Gg^Efm      , Gg          , Gg          , Re^Gvs      , Gg^Eff      , Gg^Eff      , Re^Gvs      , Re^Gvs      , Re^Gvs      , Re^Gvs      , Re^Gvs      , Re^Gvs      , Re^Gvs      , Re^Gvs      , Re^Gvs      , Re^Vh       , Re^Gvs      , Rp          , Re^Gvs      , Re^Gvs      , Gg^Wm       , Re^Gvs      , Re^Gvs      , Re^Gvs      , Re^Gvs      , Re^Gvs      , Re^Vh       , Re          , Rb          , Re^Gvs      , Re^Gvs      , Re^Gvs      , Rb          , Rb          , Re^Gvs      , Re^Gvs      , Re^Gvs      , Re^Gvs      , Gg^Eff      , Gg^Eff      , Rb          , Gg^Eff      , Rp          , Gg^Eff      , Rb          , Gg^Eff      , Rb          , Gg^Eff      , Gg^Eff      , Re^Gvs      
Ww          , Ww          , Ww          , Gg          , Gg          , Gg          , Gg          , Re^Gvs      , Re^Gvs      , Re^Gvs      , Re^Gvs      , Re^Gvs      , Re^Gvs      , Re^Gvs      , Re^Gvs      , Re^Gvs      , Re^Gvs      , Re^Gvs      , Re^Gvs      , Rr          , Re^Gvs      , Re^Gvs      , Re^Gvs      , Re^Gvs      , Re^Gvs      , Re^Gvs      , Re^Gvs      , Re^Gvs      , Re^Gvs      , Re^Gvs      , Re^Gvs      , Rb          , Rb          , Rb          , Re^Gvs      , Re^Gvs      , Re^Gvs      , Re^Gvs      , Gg^Eff      , Gg^Eff      , Rp          , Rp          , Rp          , Rp          , Rb          , Rp          , Rb          , 2 Rb        , Rb          , Rb          , 1 Rb        , Gg^Eff      
Ww          , Ww          , Ww          , Ww          , Ww          , Gg          , Gg          , Gg          , Gg          , Re^Gvs      , Re^Gvs      , Re^Gvs      , Re^Gvs      , Gg^Wm       , Re^Gvs      , Re^Gvs      , Re^Gvs      , Re^Gvs      , Re^Gvs      , Rrc         , Re^Gvs      , Re^Gvs      , Gg          , Re^Gvs      , Re^Gvs      , Re^Gvs      , Re^Gvs      , Re^Gvs      , Re^Gvs      , Re^Gvs      , Re^Gvs      , Re^Gvs      , Re^Gvs      , Rb          , Rb          , Re^Gvs      , Gg          , Gg^Eff      , Rp          , Rp          , Rp          , Rp          , Gg^Eff      , Rb          , Gg^Eff      , Rb          , Gg^Eff      , Rp          , Gg^Eff      , Rb          , Rb          , Rb          
Ww          , Ww          , Ww          , Ww          , Ww          , Ww          , Ww          , Gg          , Gg          , Gg          , Gg          , Re^Gvs      , Re^Gvs      , Re^Gvs      , Re^Gvs      , Re^Gvs      , Gg          , Gg          , Gg          , Rrc         , Rrc         , Gg^Efm      , Gg^Efm      , Gg^Efm      , Gg^Efm      , Gg          , Gg          , Re^Gvs      , Re^Gvs      , Re^Gvs      , Re^Gvs      , Re^Gvs      , Gg^Eff      , Gg^Eff      , Gg^Vhc      , Rrc         , Rr          , Rp          , Rp          , Rp          , Gg^Eff      , Gg^Eff      , Re^Gvs      , Gg^Eff      , Re^Gvs      , Gg^Eff      , Re^Gvs      , Gg^Eff      , Re^Gvs      , Gg^Eff      , Gg^Eff      , Rb          
Wo          , Ww          , Ww          , Ww          , Ww          , Ww          , Ww          , Gg^Efm      , Ww          , Gg          , Gg          , Gg^Efm      , Gg          , Re^Gvs      , Gg          , Gg          , Ch          , Ch          , Ch          , Kh          , Rrc         , Kh          , Ch          , Ch          , Ch          , Ch          , Ch          , Gg          , Gg          , Re^Gvs      , Gg^Eff      , Gg^Eff      , Gg^Vh       , Gg          , Rr          , Rr          , Rr          , Rp          , Gg^Eff      , Gg^Eff      , Re^Gvs      , Re^Gvs      , Re^Gvs      , Re^Gvs      , Re^Gvs      , Re^Gvs      , Re^Gvs      , Re^Gvs      , Re^Gvs      , Re^Gvs      , Re^Gvs      , Re^Gvs      
Wo          , Wo          , Wo          , Ww          , Ww          , Ww          , Ww          , Ww          , Ww          , Ww          , Gg          , Gg          , Gg          , Gg          , Ch          , Ch          , Gg^Efm      , Gg^Fet      , Gg          , Gg^Efm      , Rrc         , Gg          , Gg          , Gg          , Gd          , Gd          , Rp^Vhcr     , Ch          , Ch          , Gg          , Gg^Vh       , Gg^Vhc      , Rrc         , Rr          , Rr          , Rr          , Gg^Eff      , Gg^Eff      , Re^Gvs      , Re^Gvs      , Re^Gvs      , Re^Gvs      , Re^Gvs      , Re^Gvs      , Re^Gvs      , Re^Gvs      , Re^Gvs      , Re^Gvs      , Re^Gvs      , Re^Gvs      , Re^Gvs      , Re^Gvs      
Wo          , Wo          , Wo          , Wo          , Wo          , Wo          , Wo          , Wo          , Ww          , Wwr         , Ww          , Gg          , Ch          , Ch          , Gg^Efm      , Gg^Efm      , Rrc^Vhc     , Rrc         , Rrc         , Rrc         , Rrc^Vhc     , Gg^Efm      , Rrc^Vhc     , Gg          , Gg          , Rb          , Gd          , Gd          , Kh          , Gg          , Rrc         , Rrc         , Rr          , Rr          , Gg          , Gg^Vh       , Gg^Eff      , Gg^Eff      , Gg^Eff      , Re^Gvs      , Re^Gvs      , Re^Gvs      , Re^Gvs      , Re^Gvs      , Re^Gvs      , Re^Gvs      , Re^Gvs      , Re^Gvs      , Re^Gvs      , Re^Gvs      , Re^Gvs      , Re^Gvs      
Wo          , Wo          , Wo          , Wo          , Wo          , Wo          , Wo          , Wo          , Wo          , Ww          , Wwr         , Ww          , Ww          , Gg          , Rrc^Vhc     , Rrc         , Rrc         , Rrc^Vhc     , Rrc         , Gg^Efm      , Ww          , Ww          , Ww          , Gg^Efm      , Gg          , Gg          , Gg          , Gg          , Rrc         , Rrc         , Rrc         , Rrc         , Gg^Vhc      , Gg          , Gg^Eff      , Gg^Eff      , Re^Gvs      , Re^Gvs      , Re^Gvs      , Gg^Eff      , Gg^Eff      , Re^Gvs      , Re^Gvs      , Re^Gvs      , Re^Gvs      , Re^Gvs      , Re^Gvs      , Re^Gvs      , Re^Gvs      , Re^Gvs      , Re^Gvs      , Re^Gvs      
Wo          , Wo          , Wo          , Wo          , Wo          , Wo          , Ww          , Ww          , Ww          , Wwr         , Wo          , Wo          , Ww          , Ww          , Ww^Bsb/     , Rrc         , Rrc^Vhc     , Rrc         , Rrc         , Rrc^Vhc     , Ww          , Ww          , Ww          , Rrc^Vhc     , Gg^Efm      , Gg          , Rrc         , Rrc         , Rrc         , Rrc         , Gg          , Gg          , Gg^Eff      , Gg^Eff      , Re^Gvs      , Re^Gvs      , Re^Gvs      , Re^Gvs      , Re^Gvs      , Re^Gvs      , Re^Gvs      , Gg^Eff      , Gg^Eff      , Re^Gvs      , Re^Gvs      , Re^Gvs      , Re^Gvs      , Re^Gvs      , Re^Gvs      , Re^Gvs      , Re^Gvs      , Re^Gvs      
Wo          , Wo          , Wo          , Wo          , Ww          , Ww          , Ch          , Chr         , Chr         , Wwr         , Ww          , Ww          , Ww^Bsb/     , Ww^Bsb/     , Ww          , Ww          , Ww          , Rrc^Vhc     , Rrc         , Gg^Efm      , Rrc^Vhc     , Ww          , Rrc^Vhc     , Gg^Efm      , Rrc         , Rrc         , Rrc         , Rrc         , Gg^Efm      , Kh          , Ch          , Gg^Eff      , Re^Gvs      , Re^Gvs      , Re^Gvs      , Re^Gvs      , Re^Gvs      , Re^Gvs      , Re^Gvs      , Re^Gvs      , Re^Gvs      , Re^Gvs      , Re^Gvs      , Gg^Eff      , Gg^Eff      , Re^Gvs      , Re^Gvs      , Re^Gvs      , Re^Gvs      , Re^Gvs      , Re^Gvs      , Re^Gvs      
Wo          , Wo          , Wo          , Wo          , Khr         , Chr         , Re^Vhr      , Rp^Vhr      , Rp^Vhr      , Rr^Vhr      , Rr          , Ww^Bsb/     , Ww          , Ww          , Ww^Bw/      , Ww          , Ww          , Ww          , Ww          , Rrc         , Rrc         , Gg^Efm      , Rrc         , Rrc         , Rrc^Vhc     , Rrc^Vhc     , Rrc         , Rrc^Vhc     , Rrc^Vhc     , Gg^Efm      , Gg^Fet      , Ch          , Ch          , Re^Gvs      , Re^Gvs      , Re^Gvs      , Re^Gvs      , Re^Gvs      , Re^Gvs      , Re^Gvs      , Re^Gvs      , Re^Gvs      , Re^Gvs      , Re^Gvs      , Re^Gvs      , Gg^Eff      , Gg^Eff      , Re^Gvs      , Re^Gvs      , Re^Gvs      , Re^Gvs      , Re^Gvs      
Wo          , Wo          , Wo          , Wo          , Ch          , Rr^Vhr      , Re^Vhr      , Rp          , Rp          , Rp^Vhr      , Rr          , Rr^Vhc      , Rrc         , Rrc         , Ww          , Ww          , Ww          , Ww          , Ww          , Ww          , Rrc         , Rrc         , Rrc^Vhc     , Rrc^Vhc     , Rrc         , Rrc         , Rrc         , Rrc         , Rrc         , Rrc^Vhc     , Rrc^Vhc     , Gg^Efm      , Gg^Efm      , Ch          , Ch          , Re^Gvs      , Re^Gvs      , Re^Gvs      , Re^Gvs      , Re^Gvs      , Re^Gvs      , Re^Gvs      , Gg^Wm       , Re^Gvs      , Re^Gvs      , Re^Gvs      , Re^Gvs      , Gg^Eff      , Gg^Eff      , Re^Gvs      , Re^Gvs      , Re^Gvs      
Wo          , Wo          , Wo          , Wo          , Chr         , Re^Vhr      , Rp          , Rp          , Rp^Vhr      , Rp          , Rr          , Rrc         , Ww          , Ww^Bw\      , Ww          , Ww          , Ww          , Ww          , Ww          , Ww          , Ww          , Rrc^Vhc     , Rrc         , Rrc         , Rrc         , Rrc         , Rrc         , Rrc         , Rrc^Vhc     , Rrc         , Rrc         , Rrc^Vhc     , Rrc^Vhc     , Gg^Efm      , Gg^Fet      , Ch          , Ch          , Re^Gvs      , Re^Gvs      , Re^Gvs      , Re^Gvs      , Re^Gvs      , Re^Gvs      , Re^Gvs      , Re^Gvs      , Re^Gvs      , Re^Gvs      , Re^Gvs      , Gg^Eff      , Gg^Eff      , Gg^Eff      , Re^Gvs      
Wo          , Wo          , Wo          , Wo          , Chr         , Re^Vhr      , Re^Vhr      , Rr^Vhr      , Rrc^Vhc     , Rr          , Ww          , Ww^Bw\      , Ww          , Ww          , Ww          , Ww          , Wo          , Wo          , Ww          , Ww          , Ww          , Ww          , Rrc         , Rrc^Vhc     , Rrc^Vhc     , Rrc         , Rrc         , Rrc^Vhc     , Rrc^Vhc     , Rrc^Vhc     , Rrc^Vhc     , Rrc         , Rrc         , Rrc^Vhc     , Rrc^Vhc     , Gg^Efm      , Ch          , Re^Gvs      , Re^Gvs      , Re^Gvs      , Re^Gvs      , Re^Gvs      , Re^Gvs      , Re^Gvs      , Re^Gvs      , Re^Gvs      , Gg^Eff      , Gg^Eff      , Re^Gvs      , Re^Gvs      , Re^Gvs      , Gg^Eff      
Wo          , Wo          , Wo          , Wo          , Ch          , Rp^Vhr      , Rp          , Rp^Vhr      , Rp          , Rrc         , Ww^Bw\      , Ww          , Ww          , Wo          , Wo          , Wo          , Wo          , Wo          , Ww          , Ww          , Ww^Bw\      , Ww          , Rrc         , Gg          , Gg^Eff      , Rp^Ve       , Rrc^Vhc     , Rrc         , Rrc         , Rrc^Vhc     , Rrc^Vhh     , Rrc^Vhc     , Rrc^Vhc     , Rrc         , Rrc         , Gg^Fet      , Ch          , Re^Gvs      , Re^Gvs      , Re^Gvs      , Re^Vh       , Re^Gvs      , Re^Gvs      , Re^Gvs      , Re^Gvs      , Re^Gvs      , Re^Gvs      , Gg^Eff      , Gg^Eff      , Re^Gvs      , Re^Gvs      , Re^Gvs      
Wo          , Wo          , Wo          , Wo          , Chr         , Rp^Vhr      , Rp^Vhr      , Rp          , Rr          , Ww          , Ww          , Ww          , Ww          , Wo          , Ww          , Ww          , Wo          , Wo          , Wo          , Ww          , Ww          , Rrc         , Gg^Eff      , Gg^Eff      , Gg^Fp       , Gg          , Gg^Eff      , Rrc^Vhc     , Rrc^Vhh     , Rrc         , Rrc         , Rrc^Vhc     , Rrc^Vhc     , Rrc^Vhc     , Gg^Efm      , Kh          , Rr          , Re^Gvs      , Rr          , Rr          , Rp          , Re^Gvs      , Re^Gvs      , Re^Gvs      , Re^Gvs      , Re^Gvs      , Re^Gvs      , Re^Gvs      , Gg^Eff      , Gg^Eff      , Re^Gvs      , Re^Gvs      
Wo          , Wo          , Wo          , Wo          , Kh          , Rp^Vhr      , Rp          , Rp^Vhr      , Rr          , Ww          , Ww^Bw/      , Ww          , Ww          , Ww          , Ww          , Ww          , Wo          , Wo          , Ww          , Ww          , Ww          , Gg^Eff      , Gg^Eff      , Gg^Fp       , Gg^Fp       , Gg^Fp       , Gg^Eff      , Gg^Eff      , Gg^Efm      , Rrc^Vhc     , Rrc^Vhc     , Rrc         , Rrc         , Rrc         , Rrc         , Rrc         , Gg          , Rr          , Re^Gvs      , Re^Gvs      , Re^Gvs      , Rp          , Rp          , Re^Gvs      , Re^Gvs      , Re^Gvs      , Re^Gvs      , Re^Gvs      , Rb          , Re^Gvs      , Re^Gvs      , Re^Gvs      
Wo          , Wo          , Wo          , Wo          , Wo          , Ch          , Rp^Vhr      , Rp          , Rp^Vhr      , Rr          , Rr          , Ww          , Rr          , Ww^Bw/      , Ww          , Ww          , Ww          , Wo          , Ww          , Ww          , Ww          , Gg^Eff      , Gg^Eff      , Gg^Fp       , Gg^Eff      , Gg^Eff      , Gg^Fet      , Gg^Fet      , Rrc^Vhh     , Rrc^Vhc     , Rrc         , Rrc         , Rrc^Vhh     , Rrc         , Gg^Efm      , Kh          , Gg          , Re^Gvs      , Re^Gvs      , Re^Gvs      , Re^Gvs      , Re^Gvs      , Re^Gvs      , Rp          , Rb          , Rb          , Rb          , Rb          , Re^Gvs      , Rb          , Rb          , Re^Gvs      
Wo          , Wo          , Wo          , Wo          , Wo          , Chr         , Rp          , Rp          , Rp          , Rp^Vhr      , Re^Vhr      , Rr          , Rrc^Vhc     , Ww          , Ww          , Ww          , Ww          , Wo          , Ww          , Ww          , Ww          , Ww          , Gg^Efm      , Gg^Eff      , Gg          , Gg          , Rrc^Vhc     , Rrc^Vhh     , Rr          , Rrc         , Rrc^Vhh     , Rr^Vhc      , Rrc^Vhc     , Rrc^Vhc     , Rr          , Ch          , Gg          , Re^Gvs      , Re^Gvs      , Re^Gvs      , Re^Gvs      , Re^Gvs      , Re^Gvs      , Re^Vh       , Re^Gvs      , Re^Gvs      , Re^Gvs      , Re^Gvs      , Re^Gvs      , Re^Gvs      , Re^Gvs      , Rb          
Wo          , Wo          , Wo          , Wo          , Wo          , Chr         , Rp^Vhr      , Re^Vhr      , Rp          , Re^Vhr      , Re^Vhr      , Rp          , Rr          , Ww^Bw/      , Ww          , Ww          , Ww          , Ww          , Ww          , Ww          , Ww          , Ww^Bw\      , Rrc         , Gg^Fet      , Rrc^Vh      , Rrc^Vh      , Rrc         , Rrc         , Rr^Vhc      , Rrc^Vhh     , Rr^Vhh      , Rr^Vh       , Rr          , Rr          , Rrc^Vhc     , Ch          , Gg          , Re^Gvs      , Re^Gvs      , Re^Gvs      , Re^Gvs      , Re^Gvs      , Re^Gvs      , Re^Gvs      , Re^Gvs      , Re^Gvs      , Re^Gvs      , Re^Gvs      , Re^Gvs      , Re^Gvs      , Re^Gvs      , Gg^Eff      
Wo          , Wo          , Wo          , Wo          , Wo          , Kh          , Ch          , Rp^Vhr      , Rp^Vhr      , Rp          , Rp          , Re^Vhr      , Rp          , Ww^Bw/      , Ww          , Ww          , Ww          , Ww          , Ww          , Wo          , Ww          , Ww^Bw\      , Rrc         , Rrc         , Rrc         , Rrc         , Rrc         , Rrc         , Rr          , Rr^Vhc      , Rrc         , Rrc         , Rrc^Vhh     , Rrc^Vhc     , Gg          , Ch          , Gg          , Re^Gvs      , Re^Gvs      , Re^Gvs      , Re^Gvs      , Re^Gvs      , Re^Gvs      , Re^Gvs      , Re^Gvs      , Re^Gvs      , Re^Gvs      , Re^Gvs      , Re^Gvs      , Re^Gvs      , Re^Gvs      , Re^Gvs      
Wo          , Wo          , Wo          , Wo          , Wo          , Wo          , Wo          , Chr         , Chr         , Rp^Vhr      , Rp^Dr       , Rp^Vhr      , Rp          , Ww          , Ww^Bw/      , Ww          , Ww          , Wo          , Ww          , Ww          , Ww          , Ww          , Gg^Efm      , Rrc^Vhc     , Rrc         , Rrc         , Rr^Vh       , Gg^Efm      , Rr          , Rr          , Rr          , Rrc^Vhh     , Gg^Efm      , Gg^Efm      , Gg^Efm      , Ch          , Re^Gvs      , Re^Gvs      , Re^Gvs      , Re^Gvs      , Re^Gvs      , Re^Gvs      , Re^Gvs      , Re^Gvs      , Re^Gvs      , Re^Gvs      , Re^Gvs      , Gg^Wm       , Re^Gvs      , Re^Gvs      , Re^Gvs      , Re^Gvs      
Wo          , Wo          , Wo          , Wo          , Wo          , Wo          , Wo          , Wo          , Ww          , Chr         , Ch          , Rp^Vhr      , Rp^Vhr      , Rp          , Wo          , Ww          , Ww          , Ww          , Ww          , Ww          , Ww          , Ww^Bw\      , Rr          , Rrc         , Rr^Vh       , Rr^Vhh      , Rrc         , Rr^Vhh      , Gg^Efm      , Rr^Vhc      , Rr          , Gg          , Rrc         , Rr^Vhh      , Gg^Efm      , Ch          , Gg^Eff      , Re^Gvs      , Re^Gvs      , Re^Gvs      , Re^Gvs      , Re^Gvs      , Re^Gvs      , Re^Gvs      , Re^Gvs      , Re^Gvs      , Re^Gvs      , Re^Gvs      , Re^Gvs      , Re^Gvs      , Re^Gvs      , Re^Gvs      
Wo          , Wo          , Wo          , Wo          , Wo          , Wo          , Wo          , Wo          , Wo          , Ww          , Wo          , Chr         , Chr         , Kh          , Wo          , Wo          , Wo          , Ww          , Wo          , Wo          , Ww          , Ww          , Gg^Efm      , Rr          , Rr^Vhh      , Rrc         , Gg^Fet      , Rr^Vhh      , Rr          , Rr^Vh       , Rrc         , Rr^Vhc      , Rrc         , Rr^Vh       , Gg^Fet      , Ch          , Re^Gvs      , Gg^Eff      , Gg^Eff      , Re^Gvs      , Gg^Eff      , Gg^Eff      , Gg^Eff      , Re^Gvs      , Re^Gvs      , Re^Gvs      , Re^Gvs      , Re^Gvs      , Re^Gvs      , Re^Gvs      , Re^Gvs      , Re^Gvs      
Wo          , Wo          , Wo          , Wo          , Wo          , Wo          , Wo          , Wo          , Wo          , Wo          , Wo          , Wo          , Wo          , Wo          , Wo          , Wo          , Wo          , Wo          , Wo          , Ww          , Ww          , Ww^Bw\      , Rr          , Rr          , Rr          , Rr          , Rr^Vh       , Rr^Vhh      , Rr          , Rr^Vh       , Rrc         , Rr^Vhh      , Rrc         , Rr^Vhc      , Gg^Efm      , Ch          , Gg          , Re^Gvs      , Re^Gvs      , Gg^Eff      , Re^Gvs      , Re^Gvs      , Re^Gvs      , Gg^Eff      , Gg^Eff      , Re^Gvs      , Re^Gvs      , Re^Gvs      , Re^Gvs      , Re^Gvs      , Re^Gvs      , Re^Gvs      
Wo          , Wo          , Wo          , Wo          , Wo          , Wo          , Wo          , Wo          , Wo          , Wo          , Wo          , Wo          , Wo          , Wo          , Wo          , Wo          , Wo          , Wo          , Wo          , Ww          , Ww          , Kh          , Gg^Efm      , Gg^Fet      , Gs^Vh       , Rr          , Rr          , Rr          , Gg^Efm      , Rr          , Rr          , Rr          , Rr          , Rr^Vh       , Gg^Fet      , Ch          , Gg          , Re^Gvs      , Re^Gvs      , Re^Gvs      , Re^Gvs      , Re^Gvs      , Re^Gvs      , Re^Gvs      , Re^Gvs      , Gg^Eff      , Gg^Eff      , Re^Gvs      , Re^Gvs      , Re^Gvs      , Gg^Eff      , Gg^Eff      
Wo          , Wo          , Wo          , Wo          , Wo          , Wo          , Wo          , Wo          , Wo          , Wo          , Wo          , Wo          , Wo          , Wo          , Wo          , Wo          , Wo          , Ww          , Ww          , Ww          , Ww          , Ch          , Ch          , Gg          , Gg^Efm      , Rr^Vhh      , Rr^Vh       , Rr          , Rr          , Rrc^Vhh     , Rrc         , Rr          , Rr          , Gg^Efm      , Gg^Efm      , Kh          , Gg          , Re^Gvs      , Re^Gvs      , Re^Gvs      , Re^Gvs      , Gg^Wm       , Re^Gvs      , Re^Gvs      , Re^Gvs      , Re^Gvs      , Re^Gvs      , Gg^Eff      , Gg^Eff      , Gg^Eff      , Re^Gvs      , Re^Gvs      
Wo          , Wo          , Wo          , Wo          , Wo          , Wo          , Wo          , Wo          , Wo          , Wo          , Wo          , Wo          , Wo          , Wo          , Wo          , Wo          , Wo          , Wo          , Wo          , Ww          , Ww          , Ww          , Ww          , Ch          , Ch          , Gg          , Gg^Efm      , Rr^Vhh      , Gg^Efm      , Gg^Fet      , Rr          , Rr^Vhh      , Rr^Vh       , Rrc         , Rrc         , Rrc         , Rp          , Re^Gvs      , Re^Gvs      , Re^Gvs      , Re^Gvs      , Re^Gvs      , Re^Gvs      , Re^Gvs      , Re^Gvs      , Re^Gvs      , Re^Gvs      , Re^Gvs      , Re^Gvs      , Re^Gvs      , Re^Gvs      , Re^Gvs      
Wo          , Wo          , Wo          , Wo          , Wo          , Wo          , Wo          , Wo          , Wo          , Wo          , Wo          , Wo          , Wo          , Wo          , Wo          , Wo          , Wo          , Wo          , Wo          , Ww          , Ww          , Ww          , Ww          , Ww          , Ww          , Ch          , Ch          , Kh          , Ch          , Rrc^Vhh     , Rr^Vhh      , Rr          , Rr          , Rr^Vh       , Gg^Efm      , Kh          , Gg          , Rp          , Rp          , Re^Gvs      , Re^Gvs      , Re^Gvs      , Rb          , Re^Gvs      , Re^Gvs      , Re^Gvs      , Re^Gvs      , Re^Gvs      , Re^Gvs      , Re^Gvs      , Re^Gvs      , Re^Gvs      
Wo          , Wo          , Wo          , Wo          , Wo          , Wo          , Wo          , Wo          , Wo          , Wo          , Wo          , Wo          , Wo          , Wo          , Wo          , Wo          , Wo          , Wo          , Wo          , Wo          , Wo          , Ww          , Wo          , Wo          , Wo          , Ww          , Ww          , Ww          , Ww          , Ch          , Gg^Efm      , Rr^Vh       , Rr^Vh       , Rr          , Ch          , Ch          , Re^Gvs      , Re^Gvs      , Re^Gvs      , Rb          , Rb          , Rb          , Re^Gvs      , Rb          , Rb          , Rb          , Rb          , Re^Gvs      , Re^Gvs      , Re^Gvs      , Rb          , Rb          
Wo          , Wo          , Wo          , Wo          , Wo          , Wo          , Wo          , Wo          , Wo          , Wo          , Wo          , Wo          , Wo          , Wo          , Wo          , Wo          , Wo          , Wo          , Wo          , Wo          , Wo          , Wo          , Wo          , Wo          , Wo          , Wo          , Ww          , Wo          , Ww          , Ch          , Gg^Efm      , Gg^Efm      , Ch          , Ch          , Gg          , Gg          , Re^Gvs      , Re^Gvs      , Re^Gvs      , Re^Gvs      , Re^Vh       , Re^Gvs      , Re^Gvs      , Rb          , Re^Gvs      , Re^Gvs      , Re^Gvs      , Rb          , Rb          , Rb          , Re^Gvs      , Re^Gvs      
Wo          , Wo          , Wo          , Wo          , Wo          , Wo          , Wo          , Wo          , Wo          , Wo          , Wo          , Wo          , Wo          , Wo          , Wo          , Wo          , Wo          , Wo          , Wo          , Wo          , Wo          , Wo          , Wo          , Wo          , Wo          , Wo          , Wo          , Ww          , Ww          , Ch          , Ch          , Ch          , Gg          , Gg          , Re^Gvs      , Re^Gvs      , Re^Gvs      , Re^Gvs      , Re^Gvs      , Re^Gvs      , Re^Gvs      , Re^Gvs      , Re^Gvs      , Rb          , Re^Gvs      , Re^Gvs      , Re^Gvs      , Re^Gvs      , Re^Gvs      , Re^Gvs      , Re^Gvs      , Re^Gvs      
Wo          , Wo          , Wo          , Wo          , Wo          , Wo          , Wo          , Wo          , Wo          , Wo          , Wo          , Wo          , Wo          , Wo          , Wo          , Wo          , Wo          , Wo          , Wo          , Wo          , Wo          , Wo          , Wo          , Wo          , Wo          , Wo          , Ww          , Wo          , Ww          , Ww          , Ww          , Gg          , Gg          , Gg          , Re^Gvs      , Re^Gvs      , Re^Gvs      , Re^Gvs      , Re^Gvs      , Re^Gvs      , Re^Gvs      , Re^Gvs      , Re^Gvs      , Rb          , Rb          , Re^Gvs      , Re^Gvs      , Re^Gvs      , Re^Gvs      , Re^Gvs      , Re^Gvs      , Re^Gvs      
Qxu         , Wo          , Wo          , Wo          , Wo          , Wo          , Wo          , Wo          , Wo          , Wo          , Wo          , Wo          , Wo          , Wo          , Wo          , Wo          , Wo          , Wo          , Wo          , Wo          , Wo          , Wo          , Wo          , Wo          , Wo          , Wo          , Ww          , Ww          , Ww          , Ww          , Ww          , Gg          , Gg          , Gg          , Re^Gvs      , Re^Gvs      , Re^Gvs      , Re^Gvs      , Re^Gvs      , Re^Gvs      , Re^Gvs      , Re^Gvs      , Re^Gvs      , Re^Gvs      , Re^Gvs      , Rb          , Rb          , Re^Gvs      , Re^Gvs      , Re^Gvs      , Re^Gvs      , Re^Gvs      
